
                           g                                             e
                                    
                                                                ######
                      ####                                        ####
                      ####   ########            *     ####  ###    ##                                     
        #####         ####   ##    ##                  #  #  ###    ##                                     
#############   ##########   ###  ###    ###############  #  #########     #######	######
#############   ##########   ###  ###    ###    ###########  #########     #######	######
			      
   ! Color = White   