                             c                                                        .:     :.                                                                                           .:      :.                               .:####      ####                
:.                                                                               .:#####     ####:.                                        c                                          /#####      #####\                         .:##             #                
  :.                                                                    c      .:##    #     #   ##:.                                                                        c       /#    #      #    #\                  .:#######              #                
##########\          /####\                                               .:#####      #     #     ##:.                                                                         /#####     #      #     #\               .:##                     #               /
          #\        /#    #\                                            .:##           #     #       ##:.                  .::.      .::.      .::.      .::.                  /#          #      #      #\         g#######                      #              / 
           #\   /####      #\      :.                               ######             #     #         ##:.              .:####      ####      ####      ####\            /#####           #      #       #####\     #                            #       e     /  
            #   #           #\       :.         /\     /\     /\    #                  #     #           ##:.          .:##                                  #\          /#                #      #            #\    #                            #            /###
            # e #            #\    ########\   /##\   /##\   /##\   #                  #     #             ##:. e    .:##                                     #\    /#####                 #      #             #\   #                            #e          /#      
            #\ /#             #\   #       #   #  #   #  #   #  #   #                  #     #               ##:.  .:##                                        #\  /#                      #      #              #\  #                            #          /#       
!Color=CadetBlue