                                                                                                                                    c                                                                                    e                     
              c                                                                                                                                                                                              c                                 
                                                    c                                                                    ######                                                                                                                
                                                                     #######                                             ######                                           c                                     #####                          
            #####     ########                                       #######                       c               ############                                                                                 #####                          
            #####     ########                                ###    #######                                       ############                                                                        #####    #####                          
#################     ########                   ########     ###    #######       #########     #####     ####################                                                                        #####    #####    ##########            
#################     ########       #######     ########     ###    #######       #########     #####     ####################        ###################      #######                                #####    #####    ##########     #######
#################     ########       #######     ########     ###    #######       #########     #####     ####################        ###################      #######       ########      ################    #####    ##########     #######
! Color = Aquamarine